puckdrop	decision	goals against	shots against	saves	save %
2013-02-28 19:00:00-05:00	O	2	46	44	.957
2013-03-03 15:00:00-05:00	O	2	35	33	.943
2013-03-08 19:00:00-05:00	W	2	35	33	.943
2013-03-11 19:30:00-04:00	O	2	35	33	.943
2013-03-13 19:00:00-04:00	O	3	45	42	.933
2013-03-17 17:00:00-04:00	W	1	26	25	.962
2013-03-21 19:30:00-04:00	L	2	29	27	.931
2013-03-23 14:00:00-04:00	W	3	32	29	.906
2013-04-02 19:00:00-04:00	L	3	50	47	.940
2013-04-05 19:00:00-04:00	L	4	30	26	.867
2013-04-11 19:00:00-04:00	W	1	25	24	.960
2013-04-28 19:00:00-04:00	W	2	36	34	.944
2013-10-12 22:00:00-04:00	L	3	50	47	.940
2013-10-13 20:00:00-04:00	\	2	47	45	.957
2013-10-19 14:00:00-04:00	L	2	20	18	.900
2013-11-01 19:30:00-04:00	O	4	57	53	.930
2013-11-03 13:00:00-04:00	O	0	2	2	1.000
2013-11-05 19:00:00-05:00	W	1	33	32	.970
2013-11-07 19:00:00-05:00	W	1	34	33	.971
2013-11-09 14:00:00-05:00	W	2	28	26	.929
2013-11-19 19:00:00-05:00	L	4	41	37	.902
2013-11-23 19:00:00-05:00	W	2	36	34	.944
2013-11-24 17:00:00-05:00	L	3	36	33	.917
2013-11-28 19:30:00-05:00	\	1	13	12	.923
2013-12-01 17:30:00-05:00	L	3	22	19	.864
2013-12-05 19:30:00-05:00	L	3	22	19	.864
2013-12-10 19:00:00-05:00	O	1	36	35	.972
2013-12-14 14:00:00-05:00	L	3	22	19	.864
2013-12-16 19:30:00-05:00	W	2	32	30	.938
2013-12-18 19:30:00-05:00	L	5	33	28	.848
2013-12-27 19:00:00-05:00	L	5	42	37	.881
2014-01-14 20:00:00-05:00	W	0	27	27	1.000
2014-01-26 00:00:00-05:00	L	5	22	17	.773
2014-02-04 20:00:00-05:00	W	4	50	46	.920
2014-02-08 15:00:00-05:00	\	2	9	7	.778
2014-02-27 19:30:00-05:00	L	6	15	9	.600
2014-03-10 19:30:00-04:00	O	1	13	12	.923
2014-03-15 19:00:00-04:00	O	5	48	43	.896
2014-03-16 17:00:00-04:00	L	3	22	19	.864
2014-03-18 19:30:00-04:00	L	5	28	23	.821
2014-03-20 19:30:00-04:00	L	5	28	23	.821
2014-03-22 15:00:00-04:00	L	3	44	41	.932
2014-03-24 19:30:00-04:00	W	3	38	35	.921
2014-03-25 19:30:00-04:00	O	2	41	39	.951
2014-03-30 17:00:00-04:00	W	3	40	37	.925
2014-04-05 19:00:00-04:00	W	2	43	41	.953
2014-04-10 19:30:00-04:00	W	1	39	38	.974
2014-04-13 19:30:00-04:00	W	2	28	26	.929
2014-10-11 19:00:00-04:00	W	2	40	38	.950
2014-10-18 19:00:00-04:00	W	2	40	38	.950
2014-10-25 19:00:00-04:00	O	3	29	26	.897
2014-10-28 19:00:00-04:00	W	2	38	36	.947
2014-11-01 19:00:00-04:00	L	4	30	26	.867
2014-11-09 18:00:00-05:00	L	5	30	25	.833
2014-11-20 19:30:00-05:00	W	2	35	33	.943
2014-11-22 15:00:00-05:00	L	3	33	30	.909
2014-11-25 20:00:00-05:00	W	2	29	27	.931
2014-11-29 19:00:00-05:00	L	4	32	28	.875
2014-12-13 13:00:00-05:00	W	2	31	29	.935
2014-12-15 19:00:00-05:00	O	4	33	29	.879
2014-12-20 19:00:00-05:00	L	4	29	25	.862
2015-01-04 19:00:00-05:00	L	4	30	26	.867
2015-01-08 21:00:00-05:00		2	12	10	.833
2015-01-13 20:30:00-05:00	L	5	29	24	.828
2015-01-29 19:30:00-05:00	L	4	39	35	.897
2015-01-31 15:00:00-05:00	W	2	37	35	.946
2015-02-03 19:00:00-05:00	L	2	19	17	.895
2015-02-05 19:30:00-05:00	L	2	29	27	.931
2015-02-07 19:00:00-05:00	L	3	32	29	.906
2015-02-10 19:00:00-05:00	W	1	36	35	.972
2015-02-12 19:30:00-05:00	O	4	29	25	.862
2015-02-14 14:00:00-05:00	W	2	27	25	.926
2015-02-16 19:30:00-05:00	L	4	31	27	.871
2015-10-08 19:00:00-04:00		1	12	11	.917
2016-01-15 19:00:00-05:00	L	3	30	27	.900
2016-01-20 22:00:00-05:00	L	2	35	33	.943
2016-01-22 19:00:00-05:00	L	2	44	42	.955
2016-01-26 19:30:00-05:00	W	2	36	34	.944
2016-02-03 19:00:00-05:00	W	2	35	33	.943
2016-02-06 19:00:00-05:00	O	2	38	36	.947
2016-02-09 19:00:00-05:00		4	12	8	.667
2016-02-11 19:00:00-05:00	L	5	28	23	.821
2016-02-15 00:30:00-05:00	W	1	35	34	.971
2016-02-16 19:30:00-05:00	O	1	26	25	.962
2016-02-19 19:00:00-05:00	W	0	38	38	1.000
2016-02-22 00:30:00-05:00	L	4	31	27	.871
2016-02-24 22:30:00-05:00	L	1	29	28	.966
2016-02-27 23:00:00-05:00	L	2	35	33	.943
2016-03-01 19:30:00-05:00	O	2	41	39	.951
2016-03-03 19:00:00-05:00	W	3	29	26	.897
2016-03-05 13:00:00-05:00	O	2	30	28	.933
2016-03-08 19:00:00-05:00	L	3	14	11	.786
2016-03-10 19:30:00-05:00	L	3	34	31	.912
2016-03-16 19:00:00-04:00	O	3	22	19	.864
2016-10-13 19:00:00-04:00	L	4	24	20	.833
2016-10-16 19:00:00-04:00	W	2	33	31	.939
2016-10-18 21:00:00-04:00	O	4	34	30	.882
2016-10-20 22:00:00-04:00	L	2	20	18	.900
2016-10-30 15:00:00-04:00	W	1	38	37	.974
2016-11-01 20:00:00-04:00	W	1	28	27	.964
2016-11-03 19:00:00-04:00	L	2	29	27	.931
2016-11-05 19:00:00-04:00	W	1	33	32	.970
2016-11-07 19:00:00-05:00	L	4	42	38	.905
2016-11-09 19:30:00-05:00	O	1	29	28	.966
2016-11-12 19:00:00-05:00	L	4	27	23	.852
2016-11-15 20:00:00-05:00	L	3	30	27	.900
2016-11-17 19:00:00-05:00	L	4	38	34	.895
2016-11-21 19:00:00-05:00	W	2	31	29	.935
2016-11-23 19:00:00-05:00	O	1	24	23	.958
2016-11-29 19:30:00-05:00		1	6	5	.833
2016-12-03 13:00:00-05:00	L	2	33	31	.939
2016-12-05 19:00:00-05:00	O	3	33	30	.909
2016-12-09 19:00:00-05:00	L	3	28	25	.893
2016-12-13 19:00:00-05:00	W	3	33	30	.909
2016-12-16 19:00:00-05:00	W	2	35	33	.943
2016-12-20 19:30:00-05:00	O	3	39	36	.923
2016-12-22 19:00:00-05:00	L	2	33	31	.939
2016-12-27 19:30:00-05:00	W	3	43	40	.930
2016-12-29 19:00:00-05:00	L	3	37	34	.919
2016-12-31 13:00:00-05:00	L	3	28	25	.893
2017-01-07 13:00:00-05:00	W	3	35	32	.914
2017-01-16 13:00:00-05:00	W	1	32	31	.969
2017-01-17 19:30:00-05:00		3	16	13	.813
2017-01-21 19:00:00-05:00	W	2	38	36	.947
2017-01-24 20:00:00-05:00	W	4	39	35	.897
2017-01-31 19:30:00-05:00	L	5	35	30	.857
2017-02-02 19:30:00-05:00	O	2	44	42	.955
2017-02-04 19:00:00-05:00	W	0	37	37	1.000
2017-02-06 19:00:00-05:00	L	2	39	37	.949
2017-02-09 19:00:00-05:00	L	4	43	39	.907
2017-02-11 19:00:00-05:00	W	1	44	43	.977
2017-02-12 19:30:00-05:00	L	4	31	27	.871
2017-02-14 19:30:00-05:00	W	2	41	39	.951
2017-02-16 19:30:00-05:00	W	0	23	23	1.000
2017-02-18 13:00:00-05:00	W	2	39	37	.949
2017-02-19 18:00:00-05:00	L	5	37	32	.865
2017-02-25 22:00:00-05:00	L	4	29	25	.862
2017-02-28 19:00:00-05:00	O	5	41	36	.878
2017-03-02 19:00:00-05:00	W	3	22	19	.864
2017-03-04 19:00:00-05:00	O	1	32	31	.969
2017-03-07 19:30:00-05:00	L	6	30	24	.800
2017-03-10 19:00:00-05:00	L	4	39	35	.897
2017-03-11 19:00:00-05:00	W	0	24	24	1.000
2017-03-14 22:30:00-04:00	L	4	41	37	.902
2017-03-16 22:30:00-04:00	L	2	36	34	.944
2017-03-20 19:30:00-04:00	W	1	35	34	.971
2017-03-21 19:00:00-04:00	L	3	34	31	.912
2017-03-25 19:00:00-04:00	W	2	34	32	.941
2017-03-27 19:00:00-04:00	W	2	32	30	.938
2017-04-02 15:00:00-04:00	L	4	26	22	.846
2017-04-03 19:00:00-04:00	L	3	5	2	.400
2017-04-05 19:30:00-04:00	W	1	32	31	.969
2017-04-08 19:00:00-04:00	L	3	37	34	.919
2017-10-05 19:00:00-04:00	O	2	40	38	.950
2017-10-07 19:00:00-04:00	L	4	16	12	.750
2017-10-09 15:00:00-04:00		0	9	9	1.000
2017-10-12 22:30:00-04:00	L	3	26	23	.885
2017-10-14 22:30:00-04:00	L	3	29	26	.897
2017-10-21 19:00:00-04:00	W	4	31	27	.871
2017-10-24 19:30:00-04:00	W	0	32	32	1.000
2017-10-28 13:00:00-04:00	L	3	31	28	.903
2017-11-02 22:00:00-04:00	W	4	29	25	.862
2017-11-04 20:00:00-04:00	L	3	7	4	.571
2017-11-07 19:00:00-05:00	W	1	25	24	.960
2017-11-10 19:00:00-05:00	L	2	29	27	.931
2017-11-14 19:00:00-05:00	O	5	45	40	.889
2017-11-17 19:30:00-05:00	L	3	33	30	.909
2017-11-20 19:00:00-05:00	L	3	29	26	.897
2017-11-22 19:00:00-05:00	L	2	19	17	.895
2017-11-24 19:00:00-05:00	W	1	30	29	.967
2017-11-25 19:00:00-05:00	L	3	26	23	.885
2017-11-28 19:00:00-05:00	L	2	26	24	.923
2017-12-01 19:00:00-05:00	L	4	25	21	.840
2017-12-05 21:00:00-05:00	W	2	37	35	.946
2017-12-08 20:30:00-05:00	O	3	51	48	.941
2017-12-10 19:00:00-05:00	O	3	45	42	.933
2017-12-12 19:00:00-05:00	W	2	26	24	.923
2017-12-14 19:00:00-05:00	L	2	27	25	.926
2017-12-19 19:30:00-05:00	L	1	31	30	.968
2017-12-22 19:00:00-05:00	W	2	35	33	.943
2017-12-27 19:00:00-05:00	O	3	34	31	.912
2017-12-29 19:00:00-05:00	W	3	38	35	.921
2018-01-01 13:00:00-05:00	O	3	42	39	.929
2018-01-04 20:00:00-05:00	L	6	17	11	.647
2018-01-07 13:00:00-05:00	L	2	27	25	.926
2018-01-09 19:00:00-05:00		3	17	14	.824
2018-01-18 19:30:00-05:00	L	4	34	30	.882
2018-01-20 13:00:00-05:00	L	4	19	15	.789
2018-01-23 21:00:00-05:00	W	0	33	33	1.000
2018-01-25 22:00:00-05:00	W	0	30	30	1.000
2018-01-30 19:00:00-05:00	L	2	27	25	.926
2018-02-03 19:00:00-05:00	L	1	33	32	.970
2018-02-06 19:00:00-05:00	O	4	33	29	.879
2018-02-08 19:00:00-05:00	W	3	29	26	.897
2018-02-11 19:00:00-05:00	L	5	27	22	.815
2018-02-15 19:30:00-05:00	O	3	36	33	.917
2018-02-17 13:00:00-05:00	L	4	30	26	.867
2018-02-22 19:30:00-05:00	W	2	37	35	.946
2018-02-24 19:00:00-05:00	L	4	35	31	.886
2018-03-02 19:30:00-05:00	L	4	30	26	.867
2018-03-07 19:30:00-05:00		1	19	18	.947
2018-03-08 19:30:00-05:00	W	3	40	37	.925
2018-03-10 13:00:00-05:00	O	1	34	33	.971
2018-03-15 19:00:00-04:00	L	4	38	34	.895
2018-03-24 19:00:00-04:00	L	4	12	8	.667
2018-03-29 19:00:00-04:00		3	20	17	.850
2018-10-08 13:00:00-04:00	W	0	35	35	1.000
2018-10-13 20:00:00-04:00	L	4	28	24	.857
2018-10-18 22:30:00-04:00	W	2	30	28	.933
2018-10-20 22:30:00-04:00	L	4	41	37	.902
2018-10-24 19:00:00-04:00	O	3	41	38	.927
2018-10-27 13:00:00-04:00	W	1	23	22	.957
2018-10-30 19:00:00-04:00	W	2	25	23	.920
2018-11-08 19:30:00-05:00	L	3	26	23	.885
2018-11-10 19:00:00-05:00	L	3	30	27	.900
2018-11-18 13:00:00-05:00		3	14	11	.786
2018-11-21 19:00:00-05:00	L	5	27	22	.815
2018-11-29 19:00:00-05:00	O	1	36	35	.972
2018-12-10 19:00:00-05:00	O	1	24	23	.958
2018-12-12 19:00:00-05:00	L	3	17	14	.824
2018-12-18 21:00:00-05:00	W	1	37	36	.973
2018-12-23 20:00:00-05:00	W	1	20	19	.950
2018-12-28 19:00:00-05:00	W	0	10	10	1.000
2018-12-29 19:00:00-05:00	W	0	36	36	1.000
2018-12-31 18:00:00-05:00	W	1	40	39	.975
2019-01-03 19:30:00-05:00	W	2	21	19	.905
2019-01-05 20:00:00-05:00	W	3	32	29	.906
2019-01-10 19:00:00-05:00	W	3	30	27	.900
2019-01-12 13:00:00-05:00	L	2	26	24	.923
2019-01-15 19:00:00-05:00	W	1	31	30	.968
2019-01-17 19:00:00-05:00	W	1	17	16	.941
2019-01-20 15:00:00-05:00	W	0	19	19	1.000
2019-01-22 20:30:00-05:00	O	2	40	38	.950
2019-02-02 19:00:00-05:00	W	2	36	34	.944
2019-02-05 19:00:00-05:00	L	2	26	24	.923
2019-02-09 13:00:00-05:00	W	3	28	25	.893
2019-02-12 19:00:00-05:00	L	3	22	19	.864
2019-02-16 19:00:00-05:00	W	2	36	34	.944
2019-02-21 21:00:00-05:00	O	4	41	37	.902
2019-02-23 22:00:00-05:00	W	0	36	36	1.000
2019-02-26 19:00:00-05:00	L	3	27	24	.889
2019-02-28 19:00:00-05:00	W	1	35	34	.971
2019-03-03 15:00:00-05:00	L	3	13	10	.769
2019-03-05 19:00:00-05:00		4	25	21	.840
2019-03-19 19:00:00-04:00	L	5	39	34	.872
2019-03-21 19:30:00-04:00		0	12	12	1.000
2019-03-23 13:00:00-04:00	W	2	24	22	.917
2019-03-24 15:00:00-04:00	W	0	31	31	1.000
2019-03-28 20:00:00-04:00	W	4	37	33	.892
2019-03-30 19:00:00-04:00	W	1	32	31	.969
2019-04-01 19:00:00-04:00	L	2	38	36	.947
2019-04-06 19:00:00-04:00	W	0	29	29	1.000
2019-10-12 19:00:00-04:00	O	3	33	30	.909
2019-10-18 20:30:00-04:00	W	2	39	37	.949
2019-10-22 20:30:00-04:00	O	1	34	33	.971
2019-10-24 20:30:00-04:00	L	4	23	19	.826
2019-10-27 19:00:00-04:00	W	1	39	38	.974
2019-10-29 20:00:00-04:00	L	3	51	48	.941
2019-11-02 22:30:00-04:00		0	5	5	1.000
2019-11-03 20:00:00-05:00	W	2	38	36	.947
2019-11-05 22:00:00-05:00	L	3	31	28	.903
2019-11-10 19:00:00-05:00	W	4	57	53	.930
2019-11-16 20:00:00-05:00	W	2	41	39	.951
2019-11-19 20:30:00-05:00	L	3	32	29	.906
2019-11-23 20:00:00-05:00	O	1	41	40	.976
2019-11-30 21:00:00-05:00	L	5	14	9	.643
2019-12-05 19:00:00-05:00	W	3	40	37	.925
2019-12-08 19:00:00-05:00	O	3	47	44	.936
2019-12-12 21:00:00-05:00	L	5	40	35	.875
2019-12-15 19:00:00-05:00	W	3	26	23	.885
2019-12-19 20:00:00-05:00	W	1	37	36	.973
2019-12-21 21:00:00-05:00	W	3	31	28	.903
2019-12-23 20:30:00-05:00		3	24	21	.875
2019-12-27 20:30:00-05:00	W	2	40	38	.950
2019-12-29 17:00:00-05:00	W	2	33	31	.939
2019-12-31 21:00:00-05:00	W	3	44	41	.932
2020-01-02 22:00:00-05:00	L	6	36	30	.833
2020-01-11 20:30:00-05:00	W	2	37	35	.946
2020-01-14 19:30:00-05:00	W	2	22	20	.909
2020-01-19 19:00:00-05:00	W	2	38	36	.947
2020-01-21 20:30:00-05:00	L	4	26	22	.846
2020-02-05 20:00:00-05:00	O	2	40	38	.950
2020-02-11 21:00:00-05:00	L	4	30	26	.867
2020-02-15 22:00:00-05:00	W	4	42	38	.905
2020-02-19 20:00:00-05:00	L	6	41	35	.854
2020-02-28 22:00:00-05:00	W	2	34	32	.941
2020-03-03 22:00:00-05:00	W	0	27	27	1.000
2020-03-08 19:00:00-04:00	W	3	22	19	.864
2021-01-14 22:00:00-05:00	W	2	22	20	.909
2021-01-18 22:00:00-05:00	W	2	32	30	.938
2021-01-22 21:00:00-05:00	L	4	25	21	.840
2021-01-26 21:00:00-05:00	O	4	25	21	.840
2021-02-07 15:00:00-05:00	W	3	32	29	.906
2021-03-19 22:00:00-04:00	W	2	25	23	.920
2021-03-22 22:00:00-04:00	W	1	16	15	.938
2021-03-29 22:00:00-04:00	W	1	25	24	.960
2021-04-01 22:30:00-04:00	O	2	37	35	.946
2021-04-05 20:00:00-04:00	W	1	32	31	.969
2021-04-09 22:00:00-04:00	W	4	26	22	.846
2021-04-12 22:00:00-04:00	W	2	28	26	.929
2021-04-16 22:00:00-04:00	W	0	16	16	1.000
2021-04-19 22:00:00-04:00	W	2	31	29	.935
2021-04-24 21:00:00-04:00	W	1	24	23	.958
2021-04-30 22:00:00-04:00	L	2	31	29	.935
2021-05-03 20:00:00-04:00	L	6	32	26	.813
2021-05-07 22:00:00-04:00	W	3	25	22	.880
2021-05-10 22:00:00-04:00	L	2	21	19	.905
2021-10-12 22:00:00-04:00	W	3	31	28	.903
2021-10-14 22:30:00-04:00	L	4	31	27	.871
2021-10-20 22:00:00-04:00	L	2	37	35	.946
2021-10-22 22:00:00-04:00	L	4	32	28	.875
2021-10-24 22:00:00-04:00	L	2	26	24	.923
2021-10-26 20:00:00-04:00	W	1	27	26	.963
2021-10-29 20:00:00-04:00	W	4	38	34	.895
2021-11-02 19:00:00-04:00	L	4	33	29	.879
2021-11-04 19:00:00-04:00	W	1	39	38	.974
2021-11-06 19:00:00-04:00	W	2	38	36	.947
2021-11-09 22:00:00-05:00	W	2	27	25	.926
2021-11-13 22:00:00-05:00	W	4	43	39	.907
2021-11-16 22:00:00-05:00	L	4	42	38	.905
2021-11-18 22:00:00-05:00	W	2	28	26	.929
2021-11-22 20:00:00-05:00	L	5	31	26	.839
2021-11-24 20:00:00-05:00	W	2	28	26	.929
2021-11-27 19:00:00-05:00	L	3	30	27	.900
2021-12-01 22:00:00-05:00	L	5	33	28	.848
2021-12-05 22:00:00-05:00	W	2	25	23	.920
2021-12-08 22:00:00-05:00		3	10	7	.700
2021-12-12 21:00:00-05:00	W	4	27	23	.852
2021-12-14 19:00:00-05:00	W	1	24	23	.958
2021-12-16 19:00:00-05:00	W	3	26	23	.885
2021-12-19 14:00:00-05:00	W	3	32	29	.906
2022-01-06 22:00:00-05:00	W	1	19	18	.947
